[
-                                                                                                                                                                                                     w           |
-                                                                                                                                                                                                     w           |
-                                                                                                                                                                                                     w           |
-                                                                                                                                                                                                     w           |
-                                                                              s       gs s   gs                                                                                                      w           |
-                 -----                            bbb                          --------   ----             ---          ---    ----                                                        bb        w           |
-                                                                                                                                                                                          bbb        w           |
-                                                                                                                                                ---           ----                       bbbb        w           |
-             s         gs                                                                  s       gs  s      gs                                                     s     gs           bbbbb        w           |
-              ----------                     tT         tT                 ---              --------    -------   ---          --       b  b          b  b            ------           bbbbbb        w           |
-                                     tT      uU         uU      ---                                                                    bb  bb        bb  bb                           bbbbbbb        w           |
-                           tT        uU      uU         uU            b                                                               bbb  bbb      bbb  bbb     tT               tT bbbbbbbb        w           |
-                    s     guU       guU     guU        guU            bb            b   tT    g            g  s               s     gbbbb gbbbb   gbbbb  bbbb   guU       gs      uUbbbbbbbbb      gp            |
-----------------b    b----------------------------------uU        gb  bbb         gbb   uU-------------------b    bb    bb     b-----------------------  ------------------  ------------------------------------|
------------------    ------------------------------------bbbbbbbbbbb  bbbbbbbbbbbbbbb   uU-------------------b                 b-----------------------  ------------------  ------------------------------------|
------------------****-----------------------------------------------**---------------***---------------------b*****************b-----------------------**------------------**------------------------------------|
------------------------------------------------------------------------------------------------------------------------------------------------------------------------------------------------------------------|
------------------------------------------------------------------------------------------------------------------------------------------------------------------------------------------------------------------|
------------------------------------------------------------------------------------------------------------------------------------------------------------------------------------------------------------------|
------------------------------------------------------------------------------------------------------------------------------------------------------------------------------------------------------------------|
------------------------------------------------------------------------------------------------------------------------------------------------------------------------------------------------------------------|
------------------------------------------------------------------------------------------------------------------------------------------------------------------------------------------------------------------|
------------------------------------------------------------------------------------------------------------------------------------------------------------------------------------------------------------------|
]